to aim	objetivo	to direct a goal or intention
imperative	essencial	extremely important or necessary
postpone	adiar	to delay something
behind	atrás	at or to the far side of
first off	começar	to begin with
to go over	revisar	to review or examine
once more	repetir	'an extra time	 again'
procedure	procedimento	an established way of doing something
to state	afirmar	to say something clearly
thoroughly	minuciosamente	in a detailed way
farewell party	festa de despedida	a party to say goodbye
collection	vaquinha	'money given by different people	 often used to buy a gift or help someone'
looking forward	ansioso	excited about something in the future
grandchildren	netos	children of your children
dead-end job	emprego sem futuro	a job with no growth
commute	deslocamento	travel regularly to work
talk out	conversar até resolver	to speak someone with to come up with answers to a question or to work through a problem
figure out	descobrir	to understand or solve
rusty	enferrujado	lacking skill due to lack of practice
behavior	comportamento	the way someone acts
deliver	entregar	to bring or provide something
key strengths	pontos fortes	main abilities or advantages
every other day	'dia sim	 dia não'	on alternate days
managerial	gerencial	related to management
stealing	roubo	taking something illegally
bounce off	trocar ideias	to share ideas informally
employment	emprego	work or job
duty	dever	a responsibility or task
fair	justo	reasonable or equitable
take it easy	relaxar	relax or do not worry
at least	pelo menos	not less than
duties	responsabilidades	tasks or responsibilities
tailor	adaptar	to customize for a purpose
whichever	qualquer que seja	no matter which
proofread	revisar texto	to check text for errors
leverage	aproveitar	to use something to maximum advantage
tune in	acompanhar	to pay attention or watch/listen
land	conseguir	to obtain or arrive
worthwhile	que vale a pena	worth the effort
career fair	feira de carreiras	event for job opportunities
entry-level	nível inicial	position suitable for beginners
overwhelming	avassalador	very strong or intense
seekers	recrutadores	people looking for something
at once	de uma vez	right away or simultaneously
so far	até agora	until this moment
on the spot	imediatamente	immediately or in public
grab someone’s attention	chamar a atenção de alguém	make someone notice
hook	chamar atenção	attract or catch interest
shaking hands	aperto de mãos	formal greeting gesture
compensate	pagamento	to pay someone for work done
internship	estágio	'a job	 often unpaid	 that gives someone work experiences'
booth	estande	'a small area	 sometimes a table	 that has things for sale or provide information'
follow up	acompanhar	'to ask for additional information	 to plan to continue a discussion at a later date'
availability	disponibilidade	the dates and times a person is able to work
disability	deficiência	physical or mental limitation
discriminate against	discriminar	treat unfairly
marital status	estado civil	marriage condition
vouch for	garantir	say someone is trustworthy
asset	qualidade	 a useful person or quality
cover letter	carta de apresentação	 a letter that you send in addition to your résumé and provides extra information about you
hassle	incômodo	something annoying or inconvenient
form letter	carta	a letter that is copied and sent to many people
sincerely	atenciosamente	formal email closing
aware	consciente	'knowing that something is true	 or that something exists'
slot	vaga	'tan opening for something	 such as appointment'
if that suits you	se for conveniente para você	'if that is acceptable to you	 more formal way to say “if that is okay with you”'
find out	ficar sabendo	to learn or discovery
picky	exigente	'liking things a particular way	 only liking certain things	 hard to please'
word of mouth	boca a boca	information shared verbally
advance	avanço	' move forward	 move to a higher level'
knock on wood	bater na madeira	'a phrase one says(while knowing a wood	 if possible) for good luck after mentioning a hope - “bater na madeira”'
catch some rays	pegar um sol	spend time in the sun
chill out	relaxar	relax and calm down
commute with nature	contato com a natureza	travel surrounded by nature
couch potato	sedentário	person who watches a lot of TV
concerned	preocupado	worried or anxious
grin	sorrir	to give a big smile
wink	piscar	often signal or joke
glance	olhar rapidamente	quick look
dependable	confiável	can be trusted
foolish	tolo	showing lack of good sense
settled	resolvido	decided or calm
weapon	arma	'something that is used for fighting	 such as a gun or a knife'
threaten	ameaçar	' to say that someone will be harmed or hurt	 especially if they do not do something'
burst open	abrir de repente	open suddenly and forcefully
kidnap	sequestrar	take someone by force
growl	rosnar	'if a person growls	 he or she talks is a deep voice	 often because he or she is angry'
irked	incomodado	annoyed or bothered by something
cage	gaiola	a box or an area with bars around it for keeping animals in
vanish	desaparecer	disappear suddenly
spit	cuspir	force liquid from mouth
pride	orgulho	a feeling of pleasure because you have achieve something
sneak	esgueirar-se	move quietly and secretly
here goes nothing	lá vou eu	said before trying something risky
startled	assustado	suddenly surprised
shatter	estilhaçar	break into many pieces
ankle	tornozelo	joint of the foot
trapped	preso	unable to escape
vice	vício	bad habit
whisper	sussurrar	to talk very quietly so that other people cannot hear
nod	acenar com a cabeça	move head up and down
blasted	destruído	an old expression to show anger or dislike
glare	olhar com raiva	to look at someone in a way that shows you are very angry
showdown	confronto final	final decisive conflict
murmur	murmurar	speak quietly and unclearly